Country	Region	Code
Aruba	Latin America & Caribbean (all income levels)	AW
Afghanistan	South Asia	AF
Africa	Aggregates	A9
Angola	Sub-Saharan Africa (all income levels)	AO
Albania	Europe & Central Asia (all income levels)	AL
Andorra	Europe & Central Asia (all income levels)	AD
Andean Region	Aggregates	L5
Arab World	Aggregates	1A
United Arab Emirates	Middle East & North Africa (all income levels)	AE
Argentina	Latin America & Caribbean (all income levels)	AR
Armenia	Europe & Central Asia (all income levels)	AM
American Samoa	East Asia & Pacific (all income levels)	AS
Antigua and Barbuda	Latin America & Caribbean (all income levels)	AG
Australia	East Asia & Pacific (all income levels)	AU
Austria	Europe & Central Asia (all income levels)	AT
Azerbaijan	Europe & Central Asia (all income levels)	AZ
Burundi	Sub-Saharan Africa (all income levels)	BI
Belgium	Europe & Central Asia (all income levels)	BE
Benin	Sub-Saharan Africa (all income levels)	BJ
Burkina Faso	Sub-Saharan Africa (all income levels)	BF
Bangladesh	South Asia	BD
Bulgaria	Europe & Central Asia (all income levels)	BG
Bahrain	Middle East & North Africa (all income levels)	BH
Bahamas, The	Latin America & Caribbean (all income levels)	BS
Bosnia and Herzegovina	Europe & Central Asia (all income levels)	BA
Belarus	Europe & Central Asia (all income levels)	BY
Belize	Latin America & Caribbean (all income levels)	BZ
Bermuda	North America	BM
Bolivia	Latin America & Caribbean (all income levels)	BO
Brazil	Latin America & Caribbean (all income levels)	BR
Barbados	Latin America & Caribbean (all income levels)	BB
Brunei Darussalam	East Asia & Pacific (all income levels)	BN
Bhutan	South Asia	BT
Botswana	Sub-Saharan Africa (all income levels)	BW
Sub-Saharan Africa (IFC classification)	Aggregates	C9
Central African Republic	Sub-Saharan Africa (all income levels)	CF
Canada	North America	CA
East Asia and the Pacific (IFC classification)	Aggregates	C4
Central Europe and the Baltics	Aggregates	B8
Europe and Central Asia (IFC classification)	Aggregates	C5
Switzerland	Europe & Central Asia (all income levels)	CH
Channel Islands	Europe & Central Asia (all income levels)	JG
Chile	Latin America & Caribbean (all income levels)	CL
China	East Asia & Pacific (all income levels)	CN
Cote d'Ivoire	Sub-Saharan Africa (all income levels)	CI
Latin America and the Caribbean (IFC classification)	Aggregates	C6
Middle East and North Africa (IFC classification)	Aggregates	C7
Cameroon	Sub-Saharan Africa (all income levels)	CM
Congo, Dem. Rep.	Sub-Saharan Africa (all income levels)	CD
Congo, Rep.	Sub-Saharan Africa (all income levels)	CG
Colombia	Latin America & Caribbean (all income levels)	CO
Comoros	Sub-Saharan Africa (all income levels)	KM
Cabo Verde	Sub-Saharan Africa (all income levels)	CV
Costa Rica	Latin America & Caribbean (all income levels)	CR
South Asia (IFC classification)	Aggregates	C8
Caribbean small states	Aggregates	S3
Cuba	Latin America & Caribbean (all income levels)	CU
Curacao	Latin America & Caribbean (all income levels)	CW
Cayman Islands	Latin America & Caribbean (all income levels)	KY
Cyprus	Europe & Central Asia (all income levels)	CY
Czech Republic	Europe & Central Asia (all income levels)	CZ
Germany	Europe & Central Asia (all income levels)	DE
Djibouti	Middle East & North Africa (all income levels)	DJ
Dominica	Latin America & Caribbean (all income levels)	DM
Denmark	Europe & Central Asia (all income levels)	DK
Dominican Republic	Latin America & Caribbean (all income levels)	DO
Algeria	Middle East & North Africa (all income levels)	DZ
East Asia & Pacific (developing only)	Aggregates	4E
East Asia & Pacific (all income levels)	Aggregates	Z4
Europe & Central Asia (developing only)	Aggregates	7E
Europe & Central Asia (all income levels)	Aggregates	Z7
Ecuador	Latin America & Caribbean (all income levels)	EC
Egypt, Arab Rep.	Middle East & North Africa (all income levels)	EG
Euro area	Aggregates	XC
Eritrea	Sub-Saharan Africa (all income levels)	ER
Spain	Europe & Central Asia (all income levels)	ES
Estonia	Europe & Central Asia (all income levels)	EE
Ethiopia	Sub-Saharan Africa (all income levels)	ET
European Union	Aggregates	EU
Fragile and conflict affected situations	Aggregates	F1
Finland	Europe & Central Asia (all income levels)	FI
Fiji	East Asia & Pacific (all income levels)	FJ
France	Europe & Central Asia (all income levels)	FR
Faeroe Islands	Europe & Central Asia (all income levels)	FO
Micronesia, Fed. Sts.	East Asia & Pacific (all income levels)	FM
Gabon	Sub-Saharan Africa (all income levels)	GA
United Kingdom	Europe & Central Asia (all income levels)	GB
Georgia	Europe & Central Asia (all income levels)	GE
Ghana	Sub-Saharan Africa (all income levels)	GH
Guinea	Sub-Saharan Africa (all income levels)	GN
Gambia, The	Sub-Saharan Africa (all income levels)	GM
Guinea-Bissau	Sub-Saharan Africa (all income levels)	GW
Equatorial Guinea	Sub-Saharan Africa (all income levels)	GQ
Greece	Europe & Central Asia (all income levels)	GR
Grenada	Latin America & Caribbean (all income levels)	GD
Greenland	Europe & Central Asia (all income levels)	GL
Guatemala	Latin America & Caribbean (all income levels)	GT
Guam	East Asia & Pacific (all income levels)	GU
Guyana	Latin America & Caribbean (all income levels)	GY
High income	Aggregates	XD
Hong Kong SAR, China	East Asia & Pacific (all income levels)	HK
Honduras	Latin America & Caribbean (all income levels)	HN
Heavily indebted poor countries (HIPC)	Aggregates	XE
Croatia	Europe & Central Asia (all income levels)	HR
Haiti	Latin America & Caribbean (all income levels)	HT
Hungary	Europe & Central Asia (all income levels)	HU
Indonesia	East Asia & Pacific (all income levels)	ID
Isle of Man	Europe & Central Asia (all income levels)	IM
India	South Asia	IN
Not classified	Aggregates	XY
Ireland	Europe & Central Asia (all income levels)	IE
Iran, Islamic Rep.	Middle East & North Africa (all income levels)	IR
Iraq	Middle East & North Africa (all income levels)	IQ
Iceland	Europe & Central Asia (all income levels)	IS
Israel	Middle East & North Africa (all income levels)	IL
Italy	Europe & Central Asia (all income levels)	IT
Jamaica	Latin America & Caribbean (all income levels)	JM
Jordan	Middle East & North Africa (all income levels)	JO
Japan	East Asia & Pacific (all income levels)	JP
Kazakhstan	Europe & Central Asia (all income levels)	KZ
Kenya	Sub-Saharan Africa (all income levels)	KE
Kyrgyz Republic	Europe & Central Asia (all income levels)	KG
Cambodia	East Asia & Pacific (all income levels)	KH
Kiribati	East Asia & Pacific (all income levels)	KI
St. Kitts and Nevis	Latin America & Caribbean (all income levels)	KN
Korea, Rep.	East Asia & Pacific (all income levels)	KR
Kosovo	Europe & Central Asia (all income levels)	KV
Kuwait	Middle East & North Africa (all income levels)	KW
Latin America & Caribbean (developing only)	Aggregates	XJ
Lao PDR	East Asia & Pacific (all income levels)	LA
Lebanon	Middle East & North Africa (all income levels)	LB
Liberia	Sub-Saharan Africa (all income levels)	LR
Libya	Middle East & North Africa (all income levels)	LY
St. Lucia	Latin America & Caribbean (all income levels)	LC
Latin America & Caribbean (all income levels)	Aggregates	ZJ
Latin America and the Caribbean	Aggregates	L4
Least developed countries: UN classification	Aggregates	XL
Low income	Aggregates	XM
Liechtenstein	Europe & Central Asia (all income levels)	LI
Sri Lanka	South Asia	LK
Lower middle income	Aggregates	XN
Low & middle income	Aggregates	XO
Lesotho	Sub-Saharan Africa (all income levels)	LS
Lithuania	Europe & Central Asia (all income levels)	LT
Luxembourg	Europe & Central Asia (all income levels)	LU
Latvia	Europe & Central Asia (all income levels)	LV
Macao SAR, China	East Asia & Pacific (all income levels)	MO
St. Martin (French part)	Latin America & Caribbean (all income levels)	MF
Morocco	Middle East & North Africa (all income levels)	MA
Mexico and Central America	Aggregates	L6
Monaco	Europe & Central Asia (all income levels)	MC
Moldova	Europe & Central Asia (all income levels)	MD
Madagascar	Sub-Saharan Africa (all income levels)	MG
Maldives	South Asia	MV
Middle East & North Africa (all income levels)	Aggregates	ZQ
Mexico	Latin America & Caribbean (all income levels)	MX
Marshall Islands	East Asia & Pacific (all income levels)	MH
Middle income	Aggregates	XP
Macedonia, FYR	Europe & Central Asia (all income levels)	MK
Mali	Sub-Saharan Africa (all income levels)	ML
Malta	Middle East & North Africa (all income levels)	MT
Myanmar	East Asia & Pacific (all income levels)	MM
Middle East & North Africa (developing only)	Aggregates	XQ
Montenegro	Europe & Central Asia (all income levels)	ME
Mongolia	East Asia & Pacific (all income levels)	MN
Northern Mariana Islands	East Asia & Pacific (all income levels)	MP
Mozambique	Sub-Saharan Africa (all income levels)	MZ
Mauritania	Sub-Saharan Africa (all income levels)	MR
Mauritius	Sub-Saharan Africa (all income levels)	MU
Malawi	Sub-Saharan Africa (all income levels)	MW
Malaysia	East Asia & Pacific (all income levels)	MY
North America	Aggregates	XU
North Africa	Aggregates	M2
Namibia	Sub-Saharan Africa (all income levels)	NA
New Caledonia	East Asia & Pacific (all income levels)	NC
Niger	Sub-Saharan Africa (all income levels)	NE
Nigeria	Sub-Saharan Africa (all income levels)	NG
Nicaragua	Latin America & Caribbean (all income levels)	NI
Netherlands	Europe & Central Asia (all income levels)	NL
High income: nonOECD	Aggregates	XR
Norway	Europe & Central Asia (all income levels)	NO
Nepal	South Asia	NP
New Zealand	East Asia & Pacific (all income levels)	NZ
High income: OECD	Aggregates	XS
OECD members	Aggregates	OE
Oman	Middle East & North Africa (all income levels)	OM
Other small states	Aggregates	S4
Pakistan	South Asia	PK
Panama	Latin America & Caribbean (all income levels)	PA
Peru	Latin America & Caribbean (all income levels)	PE
Philippines	East Asia & Pacific (all income levels)	PH
Palau	East Asia & Pacific (all income levels)	PW
Papua New Guinea	East Asia & Pacific (all income levels)	PG
Poland	Europe & Central Asia (all income levels)	PL
Puerto Rico	Latin America & Caribbean (all income levels)	PR
Korea, Dem. Rep.	East Asia & Pacific (all income levels)	KP
Portugal	Europe & Central Asia (all income levels)	PT
Paraguay	Latin America & Caribbean (all income levels)	PY
West Bank and Gaza	Middle East & North Africa (all income levels)	PS
Pacific island small states	Aggregates	S2
French Polynesia	East Asia & Pacific (all income levels)	PF
Qatar	Middle East & North Africa (all income levels)	QA
Romania	Europe & Central Asia (all income levels)	RO
Russian Federation	Europe & Central Asia (all income levels)	RU
Rwanda	Sub-Saharan Africa (all income levels)	RW
South Asia	Aggregates	8S
Saudi Arabia	Middle East & North Africa (all income levels)	SA
Southern Cone Extended	Aggregates	L7
Sudan	Sub-Saharan Africa (all income levels)	SD
Senegal	Sub-Saharan Africa (all income levels)	SN
Singapore	East Asia & Pacific (all income levels)	SG
Solomon Islands	East Asia & Pacific (all income levels)	SB
Sierra Leone	Sub-Saharan Africa (all income levels)	SL
El Salvador	Latin America & Caribbean (all income levels)	SV
San Marino	Europe & Central Asia (all income levels)	SM
Somalia	Sub-Saharan Africa (all income levels)	SO
Serbia	Europe & Central Asia (all income levels)	RS
Sub-Saharan Africa (developing only)	Aggregates	ZF
South Sudan	Sub-Saharan Africa (all income levels)	SS
Sub-Saharan Africa (all income levels)	Aggregates	ZG
Small states	Aggregates	S1
Sao Tome and Principe	Sub-Saharan Africa (all income levels)	ST
Suriname	Latin America & Caribbean (all income levels)	SR
Slovak Republic	Europe & Central Asia (all income levels)	SK
Slovenia	Europe & Central Asia (all income levels)	SI
Sweden	Europe & Central Asia (all income levels)	SE
Swaziland	Sub-Saharan Africa (all income levels)	SZ
Sint Maarten (Dutch part)	Latin America & Caribbean (all income levels)	SX
Sub-Saharan Africa excluding South Africa	Aggregates	A4
Seychelles	Sub-Saharan Africa (all income levels)	SC
Syrian Arab Republic	Middle East & North Africa (all income levels)	SY
Turks and Caicos Islands	Latin America & Caribbean (all income levels)	TC
Chad	Sub-Saharan Africa (all income levels)	TD
Togo	Sub-Saharan Africa (all income levels)	TG
Thailand	East Asia & Pacific (all income levels)	TH
Tajikistan	Europe & Central Asia (all income levels)	TJ
Turkmenistan	Europe & Central Asia (all income levels)	TM
Timor-Leste	East Asia & Pacific (all income levels)	TL
Tonga	East Asia & Pacific (all income levels)	TO
Trinidad and Tobago	Latin America & Caribbean (all income levels)	TT
Tunisia	Middle East & North Africa (all income levels)	TN
Turkey	Europe & Central Asia (all income levels)	TR
Tuvalu	East Asia & Pacific (all income levels)	TV
Tanzania	Sub-Saharan Africa (all income levels)	TZ
Uganda	Sub-Saharan Africa (all income levels)	UG
Ukraine	Europe & Central Asia (all income levels)	UA
Upper middle income	Aggregates	XT
Uruguay	Latin America & Caribbean (all income levels)	UY
United States	North America	US
Uzbekistan	Europe & Central Asia (all income levels)	UZ
St. Vincent and the Grenadines	Latin America & Caribbean (all income levels)	VC
Venezuela, RB	Latin America & Caribbean (all income levels)	VE
Virgin Islands (U.S.)	Latin America & Caribbean (all income levels)	VI
Vietnam	East Asia & Pacific (all income levels)	VN
Vanuatu	East Asia & Pacific (all income levels)	VU
World	Aggregates	1W
Samoa	East Asia & Pacific (all income levels)	WS
Sub-Saharan Africa excluding South Africa and Nigeria	Aggregates	A5
Yemen, Rep.	Middle East & North Africa (all income levels)	YE
South Africa	Sub-Saharan Africa (all income levels)	ZA
Zambia	Sub-Saharan Africa (all income levels)	ZM
Zimbabwe	Sub-Saharan Africa (all income levels)	ZW
